NO ./path_to_the_south_texture
SO ./path_to_the_south_texture
WE ./path_to_the_west_texture
EA ./path_to_the_east_texture
F 220,100,0
C 225,30,0

111111111111111111111111111
100000000011000000000   000
101100000111000000000000111
10010000000000000000000011111111
111111111111000001110000000000001
10000SP00011000001110111111111111
11110111111111011100000010001
11110111111111011101010010001
  11001000110101011100000010001
1W010000000000001100001 10000
1110000000000000110101N010001
11000001110101011111011110N0111
11110111 1110101 101111010001
11111111 1111111 111111111111








1111111                          11111
1  N                             1 N 1
1111111                          11111

