NO ./texture/no.xpm
SO ./texture/so.xpm
WE ./texture/we.xpm
F  10,19,0



1111111111111111111111111111111
100000000000000000S000111111
1111111111111111111111111111111
EA ./texture/ea.xpm
C 225,30,0
100000000000000000000000000000111111111
11111111111111111N00000111111111111
1000000000000000000000000000000001
1000000000000000000000000000000001
1000000000000000000000000000000001
100000000000000000N000000000000001
1000000000000000000000000000000001
100000000S000000000000000000000001
11111111111111111111111111111111111111111111111