NO         				 ./path_to_the_north_texture









C																			225,30,0










SO 																				./path_to_the_south_texture
SO 																				./path_to_the_south_texture
WE ./path_to_the_west_texture

EA 										            ./path_to_the_east_texture


F							 220,100,0









0000000000000000000000000
1000000000110000000000001
1011000001110000000000001
10010000000000000000S0001
1111111110110000011100001
100000000011000001110111111111111
11110111111111011100000010001
11110111111111011101010010001
1100000011010101110000001001
100000M000000N00110000001001
10000000000000001101010010N01
1100000111010101111101111000111
11110111 1110101 101111010001
111111111111111      11111111111111
